 ########
##      #
#   @   #
#   &   #
#  *  #
####  #
.   #  #
.   #  ##
.   #####