  #####
###   #
#  &  #
### # #
# ##  #
# # * ##
#   &  #
#      #
##     ##
##########