  #####
###   #
#   @ #
##    #
# ##  #
# # * ##
#      #
#  &    #
##     ##
##########