  #####
###   #
#     #
##    #
# ##  #
# # * ##
#   &  #
#      #
##     ##
##########