  #####
###   #
#     #
### # #
# ##  #
# # * ##
#   &  #
#      #
##      ##
##########