 ########
##    @ #
#@  @ & #
# &  &  #
#  *  # #
####  # #
.   #  ##
.   #  ##
.   #####