. #####
. #  *#
. #   ####
. # & #  #
. ##    @#
.### ###@#
.# & # #@#
.# & # ###
.#   #
.#####