..#######
###    ##
#@ &@ & #
### &   #
#@##  & ##
# # &   @#
#  @* &  #
#      @ #
##########